111111111111111111111111111111111111111111111111111111111111
1222222222220000000000000022222222200X0000000000000000000001
12222220000000000fffffff44222fff0000X00000000000000000000001
12222000000004444444222222222f0000XX0000000FFF00000000000001
1222000444222222222222222244f0000X000000000FFFM0000000000001
122222222222222222222222ffff000FF0X00000000FFFF0000000000001
12222222222222200022220000000FFMF00X000000000000000000000001
12222222222222200000000000000FF00000X00000000000000000000001
122220000000022200000000000000000000X00000000000000000000001
122222ff0000000000000C000E00000000000XX000000000000000000001
12222222fff000000000000000000000000000X000000000000000000001
13322222222ff000000000000000000000P000X000000000000000000001
1333222222222f00MF000000000000000000000X00000000000000000001
1333322222222f00FF0000000000000000000000X0000000000000000001
13333333222222000000000000000000000000000X000000000000000001
133333333322222220000000000000000000000000X00000000000000001
133333333322222200000000000000000000000000X00000000000000001
13333333332222240000000000000000000000000X0000000000000000F1
1333333333322224000000000000000FFFF000000X0000000000000000M1
1333333333222240000000000000000FFMF00000X00000000000000000F1
133333333222224000000000000000000000000X000000000004444f0001
12222222222222400000000000000000000000X000000fff4422224ff001
12222222222444XXX0000XXXXX000000000ffX000000f222222222224ff1
1ffff2fff24fff000XXXX00000XXXXf422222ffff000ff22222220222221
10000f000ff000000000000000000Xf42222222222222222222400222221
10000000000000000000000000000f422222223333333222224000222221
100000000000000000000000000000f42223333333333222224000222221
100000FF000000000000000000000ff42222333333333222222202422221
10000FFF0000000000000000fffff4422233333333333332222222042221
10000MF0000000000000000f444442233333333333333332222200042221
1000000000000000000000f4222333333333333333333332222000042221
111111111111111111111111111111111111111111111111111111111111