111111111111111111111111111111111111111111111111111111111111111111111111111111111111111
111111111111111111111111111111111111111111111000111111111111111111111111111111111111111
111111111111111111111111111111111111111110000000010011111111111111111111111111111111111
11111111111111111111111111111111111111111000000C000011111111111111111111111111111111111
111111111111111111111111111111111111111110000000000000000011111111111111111111111111111
111111111111111111111111111111111111111000000000000000000011011111111111111111111111111
1111111111111111111100001111111110000000C0000000000000000000001111111111111111111111111
111111111111111111110000111111110000000000000000000000000000000000000000111111111111111
1111111111111111111110000000C0000000000000000000000000000C00000000000000010110111111111
1111111111111111111111000000000000000000000000E0000000000000000000000000000000000011111
1110000000001011011000000000000000000000000000000000000000000000000000000000000C0111111
1100C000000000000000000000000000000000000000000000000000000000000P000000000000001111111
110000000000000000000000000000000000000000000000000000000000000000000000000000011111111
1111001000000000000000000000000000000000000C00000000000000000000000000000000C0011111111
111111111111110000000000000000000000000000000000000000000000000000000000000000011111111
111111111111111111000000000000C00000000000000000000000000000000000000000000111111111111
1111111111111111110000000000000000000000000000000000C0000000000000000000011111111111111
111111111111111111100000000000000000000000000000000000000000000000000001111111111111111
111111111111111111111000000000000000000000000000000000000000000000000010011111111111111
111111111111111111111111000000000000000000000000000000000000000000000000001111111111111
111111111111111111111111000000000000000000000000000000000000000000000000000111111111111
111111111111111111111111110000000000000000000000000000000C00000000000000000111111111111
111111111111111111111111000100000000000000000000000000000000000000000000000111111111111
111111111111111111111111000C10000000000000000000000000000000000000000000011111111111111
111111111111111111111111100000000000000000000000000000000000000000000000000111111111111
111111111111111111111111000000000000000000000000000000000000000000000000001111111111111
111111111111111111111110000000000000000000000000000000000000000000000000000000011111111
111111111111111111111110000000000000000000000000000C00000000000000000000000C00111111111
1111111111111111111111000000000000000C0000000000111100100000000000000000000111111111111
11111111111111111111111000000000000000000000001111111111111100000C000000111111111111111
111111111111111111111111111000000001000000000011111111111111111111111111111111111111111
111111111111111111111111111111111111111111111111111111111111111111111111111111111111111
111111111111111111111111111111111111111111111111111111111111111111111111111111111111111