111111111111111111111111111111111111111111111111111111111111
1222222222220000000000000022222222200B0000000000000000000001
12222220000000000fffffff44222Cf00000BB0FF0000000000000000001
12222000000004444444222222222f0000BB000FM0000000000000000001
1222000444222222222222222244f00000B0000FF0000000000000000001
122222222222222222222222ffff000000BB00000000000000FF00000001
1222222222222220002222C000000000000B0000000000000FFF00000001
1222222222222220000000000000FM00000BB000000000000FFF00000001
12222000000002220000000000000F000000BB00000000000MFF00000001
122222ff00000000000000000000000000000BB000000000000000000001
12222222fff000000MF000000000000000000CB000000000000000000001
13322222222ff0000FF00000000E0000000000B000000000000000000001
1333222222222C000000000000000000000P00B000000000000000000001
1333322222222f00000000000C00000000000000B0000000000000000001
133333332222220000000000000000FFF00000B0000000000000FFFF0001
133333333322222220000000000000FMF000000B000000000000FMFF0001
133333333322222200000000000000FFF000000B00000000000000000001
1333333333222224C00000000000000000000C000B00000.000000000001
13333333333222240000000000000000000000000B000000000000000001
13333333332222400000000FFFFF000000000B0000000000000000000001
13333333322222400000000FFMFF00000000B0000000000|0004444f0001
12222222222222400000000000000000000000B000000fff4422224ff001
12222222222222}00{^^^^^^^^^^^C00000ffB000000f222222222224ff1
1ffff2fff20000000^^^^^^^^^^^}00{22222ffff000ff22222220222221
10000f000ff0000000000000000000222222222222222222222400222221
10000000000000000000000000M00f422222223333333222224000222221
100000FFFF0000000000000000FF00f42223333333333222224000222221
10000MFFFF0000000000000000000ff42222333333333222222202422221
100000000000000000000000fffff4422233333333333332222222042221
10000000000000000000000f444442233333333333333332222200042221
1000000000000000000000f4222333333333333333333332222000042221
111111111111111111111111111111111111111111111111111111111111